S111111111111111XXXXX111111111111111111111111111111X111G
11XXXXXXXXX11111X111X11111111111111111XXXX11111X111X1111
1111111111X11111X111XXXXXXXXXXXXXX1XXXX11X11111X111X1111
1111111111X11111X11XXX11111111111111XX111XXXXXXX111X1111
1111111111X1111XX11X1X111111111111111X111111111X111X1111
1111111111X1111X111X1XXX1XXXXXXXXXXXXX111X11111X111X1111
XXXXXXXX11X1111X111X11XX111111XXX1111X111X11111X111X1111
1111111111X1111X111X11X11XX1XXX111111X111X11111X111X1111
1111111111X1111X111X11X11X111XX1X1111X111X11111X111X1111
1111111111X1111X111X11X11X1111X1XX111X111X11111X111X1111
1111111111X1111X111X11XXXX1111X11X111X111X11111X111X1111
1111111111X1111X111111X111111XX11X111X111X11111X111X1111
1111111111X1111X111X11X11XXXXX111X111X111X11111X111X1111
1111111111X1111X111X11X111111111XX111X111X11111X111X1111
11XXXXXXXXX1111X111X11X11111111XX1111X111X1111XX111X1111
1111111111XX111X111X11XXXXXXXXXX1111XX111X1111X1111X1111
11111111111X111X111X1111111111111111X1111X1111X1111X1111
11111111111X111X111X111111111111111XX111XX111XX1111X1111
11111111111X111X111XXXXXXXXXXXX11XXX111XX1111X11111X1111
11111111111X111XX1111111111111XXXX1111XX1111XX11111X1111
11111111111X1111XX1111111111111111111XX1111XX111111X1111
XXXXXXXXX11XX1111XXXXXX111111111111XXX11111X1111111X1111
111111111111XX11111111XXXXXXXXXXXXX11111111X1111111X1111
1111111111111XX111111111111111111111111111XX1111111X1111
11111111111111XXXXXXXXXXXXXXXXXXXXXXXXXXXXX11111111X1111
11111111111111111111111111111111111111111111111111111111
