111111111111111X111111111111X11G1
1111111X1111111X111111X11111X1111
1111111X1111111X111111X11111X1111
1111111X1111111X111111X11111X1111
1111111X1111111X111111X11111X1111
1111111X1111111X111111X11111X1111
1111111X1111111X111111X11111X1111
1111111X1111111X111111X11111X1111
1111111X1111111X111111X11111X1111
1111111X1111111X111111X11111X1111
1111111X1111111X111111X11111X1111
1111111X1111111X111111X11111X1111
1111111X1111111X111111X11111X1111
1111111X1111111X111111X11111X1111
1111111X1111111X111111X11111X1111
S111111X11111111111111X1111111111
