111111111111111S11111111111111111
1X1111111111111X1111111111111X111
1XX11111111111XXX11111111111XX111
11XX111111111XX1XX111111111XX1111
111XX1111111XX111XX1111111XX11111
1111XX11111XX11111XX11111XX111111
11111XX11111111111111111XX1111111
111111XX111111111111111XX11111111
111111XXXXXXXXX1XXXXXXXXX11111111
XXXXXXX11111111111111111XXXXXXXXX
111111111111111111111111111111111
1X111111X111111X11111X111111X1111
1XX1111XXX1111XXX111XXX1111XXX111
11XX11XX1XX11XX1XX1XX1XX11XX1XX11
111XXXX111XXXX111XXX111XXXX111XX1
111111111111111G11111111111111111
