11111111111111111X111111111111111
1111111111111111X111111X111X11111
111111111111111X111111X1X1X1X1111
11111111111111X111111X111X111X111
1111111111111X111111X111111111X11
111111111111X111111X111111G11X111
11111111111X111111X11111X111X1111
1111111111X111111X11111X1X1X11111
11111S111X111111X11111X111X111111
11111111X111111X11111X11111111111
11111111111111X11X1111X11X1111111
1111111111111X1111X11111X11111111
111111111111X11111X1111X111111111
11111111111X1111111XX1X1X1X1X1111
1111111111X1111111111X111X1X1X111
111111111X11111111111111111111111
