11111111X111X111111111111111111111111111111111X11111X111
XX111111X111XX111XXXXXXXXXXXXXXX11111111111111XXX111X111
1XX11111X11111111XXXXXXX1111XX1XXX111X1111XXXXX1XX11X111
11XXX111XX111X11XXX1111X11XXXX111XXXXX111XX111111111XXX1
111111111X111X1XX1X11X1111111XX1111XXX111X111X111111X111
1111X1111X11XXXX11X1XX11X11111X1111XX1111111XX11X111X111
111XXXX11X1XXXXX11XXX111XXX111XXX111X1111111X111XX11X111
G1XXXXX11X111XXX1111XXX111XXXXX1111XXXXX111XX1111XXXX111
XXX11X111XX11X1X111111X111X1111111XXX11111XXX111111XX111
11111XX111X11X11X11111XXX1XXX111XXX1X1111XX11XX1111X11XX
111111X111X11XX1XXXXX1111111XX1XX111X111XX1111XX11XX1111
11111XX111111XX11111XXXXX1S1111X111XXXXXX111111111X11111
11XX1X111XXXXXX111111111111111XX1111XXXX1111111111X11111
X1X11XX11X11XXXXXXXXX11X11X1X111111XXX1111XX111111XXX1X1
XXX111XX1111X1111111111X11X1XX11111XXXX1111XXX1111X111X1
1XX1111X1111XXX1111XX11X11X11X111XXX11XXX1111X1111X111X1
111X111XX1111XXX11XX111X11X11X111XX11111XX1111XXXXX111X1
11XXX11XXXXXXXXXXXX1111X11X11X111X1111111111111XXX1111X1
11X1XX111111XXX11111X11X11XX1XXXXX1XXXXXXXXXXXXX111X1XX1
1XX11XX111X111XX1111X111X11XXXXX111X11111111X111111XXX11
111111XXX1XX1111XXX1X111XXXXX111X11X111X1111X111111XXX11
1111X111XXXXXXX1XXXXXXXXXX11XXX1X111111X1111111XXXXX1111
111XX11111111111X111X1111XX111XXXXXXXXXXXXXXXXXX11111111
11XX1111111XX11XX111XXXX11XXX1111X1111111111XX1111111X11
1XX1111111XX1111X1111X111111X1111X111XX111111XX111111XX1
111111111XX111111111111111111111111111XX111111111111111X
