S111XXXXXXXXXXXXXXX1111111111111111
11111111111111111111111111111111111
11X11111111111111111111111111111111
11XXX11111111XXXXXXXXXXXXXXXXXXXXX1
1111X111111111111111111111111111111
1111X111111111111111111111111111111
1111X11111X111111111111111111111111
1111X11111X111111XXXXXXXXXXXXXXXXXX
1111X11111X111111111111111111111111
1111X11111X11111111X111111111111111
1111X11111X11111111X111111111111111
1111X11111X111X1111X11XXXXXXXXXXXXX
1111X11111X111X1111X111111111111111
1111X11111X111X1111X111111111111111
1111X11111XXXXXXXXXXXXXXXXXXXXXXXXX
1111X11111111111111111111111111111G
