S99999999999999999999999999999999999999999999991G
1999999999999999999999999999999999999999999999191
1999999999999999999999999999999999999999999991999
1111199999999999999999999999999999999999999991999
1111119999999999999999999999999999999999999919999
1911111999999999999999999999999999999999999119999
1991111199999999999999999999999999999999991119999
1999111111999999999999999999999999999999911999999
1999911111999999999999999999999999999999111199999
9999991199999999999999999999999999999911111119999
9999999119999999999999999999999999999111111119999
9999999911199999999999999999999999991111111199999
9999999911199999999999919999999999111111199999999
9999999991119999999999119999999911111111999999999
9999999991111199999911111999991111111119999999999
9999999999111199999111111119911111111199999999999
9999999999111119991111111111111111111199999999999
9999999999991111111111111111111111111999999999999
9999999999991111111111911111111911999999999999999
9999999999999111111119991111199999999999999999999
9999999999999999999999999999999999999999999999999
9999999999999999999999999999999999999999999999999
9999999999999999999999999999999999999999999999999
