SX1X11111111X11111111X11111111111
1X1X1XXXXXXXX11XXXXXX11XXXXXXXXX1
1X1X1X111111X11X1111X111111X111X1
1X1X1X1111XXX11X11XXX111111X1X1X1
1X1X1X1111X1111X111111XXXX1X1X1X1
11111XXXX1X1111X1111XXX11X1X1X1X1
111111111111111X1111X1111X1X1X1X1
X1X11XXXXXXXXXXXXXXXX1111X1X1X1X1
11X1111111111111111111111X1X1X111
11X11111XXXXXXXXXXXX11111X111XXXX
11X11111X1111111111X11111XXXXX111
11XXXXXXX1111111111111XXXX11111X1
11111111X1XXXXXXXXXX1111111XXXXX1
XXXXXXX1X1111111111XXXXXXXXX11111
11111111X1XXXXXXXX1111111111XXXXX
11111111X11111111111111111111111G
