S111111111111111X111111111111111111111111111111X11111111
9XXXXXXXXXX11111X11111111111111111111111XX11111X111X1111
9999999999X11111X111XXXXXXXXXXXXXXXXX1111X11111X111X1111
9999999999X11111X11XXX11111111111111XX111X11111X111X1111
9999999999X1111XX11X11111111111111111X111X11111X111X1111
9999999999X1111X111X111XXXXXXXXXX1111X111X11111X111X1111
XXXXXXXX99X1111X111X11XX11111111X1111X111X11111X111X1111
9999999999X1111X111X11X111XXXX1111111X111X11111X111X1111
9999999999X1111X111X11X11XX11XX1X1111X111X11111X111X1111
9999999999X1111X111X11X11X1111X1XX111X111X11111X111X1111
9999999999X1111X111X11X11X1111X11X111X111X11111X111X1111
9999999999X1111X111111X111111XX11X111X111X11111X111X1111
9999999999X1111X111X11X11XXXXX111X111X111X11111X111X1111
9999999999X1111X111X11X111111111XX111X111X11111X111X1111
99XXXXXXXXX1111X111X11X11111111XX1111X111X1111XX111X1111
9999999999XX111X111X11XXXXXXXXXX1111XX111X1111X1111X1111
99999999999X111X111X1111111111111111X1111X1111X1111X1111
99999999999X111X111X111111111111111XX111XX111XX1111X1111
99999999999X111X111XXXXXXXXXXXX11XXX111XX1111X11111X1111
99999999999X111XX1111111111111XXXX1111XX1111XX11111X1111
99999999999X1111XX1111111111111111111XX1111XX111111X1111
XXXXXXXXX99XXX111XXXXXX111111111111XXX11111X1111111X1111
9999999999999X11111111XXXXXXXXXXXXX11111111X1111111X1111
9999999999999XX111111111111111111111111111XX1111111X1111
99999999999999XXXXXXXXXXXXXXXXXXXXXXXXXXXXX11111111X1111
999999999999991111111111111111111111111111111111111X111G
