S99999999999999999999119991191191
199119119911119991919911991199199
911991991199911199991999991119919
199199919911999111199191119911991
991119991999111991119999111991119
919119199119911199911199919999111
911991199991199111991119999119991
911999991199119999119111991111999
199111911119911119911991199119919
999119191119199111991199119999119
911991119191119911119919911991999
111999111991119199111991991191191
119911999119191119911199919999991
991111999111911119999111991919999
911119919919191191119999999191999
11119911119111991111111111999911G
