S1111XX111111XX1111111111111111111111111111111
1111XX111111XX11111XXXXXXXXXX111111XX111111111
1111X111111XX1111XXX11111111XXXX1111XX11111111
111XX1111XX11111XX11111XXX11111XX1111XXXXX1111
111X11111X11111XX1111XXX1XX11111XX1111X1111111
111X11111X1111XX11111X1111XXXX111XX111X1111111
111X1111X1111XX1111X111111111XX111X111XX111X11
111X1111XX111X1111XX1111111111XX11XX111X111X11
11XX11111X111X1111X111XXXXX1111X111X111X111X11
11X111111X111X111XX111X1111X111X111X111X11XX11
11X111111X111X111X111XXXXX1X11XX111X111X11X111
11X111111X111X111X111X11GXX111XX11XX111X11X111
11X111111XX11X111XX11XX111XX11X111X1111X11X111
11XX111111X11X1111XX11XXX1X11XX111X1111X11X111
111X111111XX1X11111XX1111111XXX111X111XX11X111
111XX11111111XX11111XXXXXXXXX1111XX111X111X111
1111X111111111XX111111111111111111XXXXX111X111
1111XXX1111111XXXX111111111111XXX1111X111XX111
111111XXX11111X111XXXXX111111XX111111XX1XX1111
11111111XX1111XX111111XXXXXX1XX111XXXXXXX11111
111111111111111XXX111111111111XXXXX111X1111111
11111111111111111XX111111111111111111111111111
