S99999999999999999999999999999999999999999999991G
1999999999999999999999999999999999999999999999191
1999999999999999999999999999999999999999999991999
1111111111111111111111111111199111111111111111999
1111111111111111111111111111999111111111111119999
1911111111111111999991111111991111119999911119999
1991111111111199999999911119911111999111991119999
1999111111199999999199911991111119911111111999999
1999911111999911111119999911111119911111111199999
1199991199991111111111999111111111999111111111111
1119999119911111111111999111111111199111111111111
1111199911111111111999999111111119991111111111111
1111199911111111119999919911111999111111199999991
1111119991111111199999119991199911111111999999999
1111119991111111999911111999991111111111111199999
1111111999111199999111111119911111111191111111999
1111111999111119991111111111111111111199111111119
1111111199911111111111111111111111111199911111111
1111111111991111111111911111111911111119991111111
1111111111999111111119991111119999111111999111111
1111111111199911119999999111111999911111119991111
1111111111119911111999999911111119991111111199911
1111111111111911111991999999111111199111111119911
