1111111111XX1111111111111XX1111111X1111111111111111111111111111111111111111111111111
1111X1111XX111111XX11111XX11111111XXXXXXXXXXXXXXXXXXX11111XXXXXXXXXXXXXXXXXXXXX11111
111XX111XX1111111X111111X11111XXX1111111111111111111XX11111XX1111111111X111111X11111
111XX111X1111111XX11111XX1111XX1111111111111111111111XX11111XX11111X111X11X111X11111
111X1111X1111111XX11111XX111XX1111111XXXXXXXXX11111111X111111X11111X111X11X111X11111
111X1111X111111XX111111X111XX11111XXXXX111111XXX111111X111111XX1111X111X11X111X11111
11XX111XX111111X111111XX11XX1111XXX111111111111XX11111XX111111X1111X111X11X111X11111
11X1111X1111111X111111X111X1111XX111111111111111XXX1111XX11111XX111X111X11X111X11111
11X1111X1111111X11111XX111X111XX111111111111111111XX1111XX11111X111X111X11X111XX1111
11X1111X111111XX11111X111XX11XX1111XXXXXXXXXX111111X11111XX1111XX11X111X11X1111X1111
11X1111X111111X11111XX111X111X11111X11111111XX11111XX11111X11111X11X111X11X1111X1111
11X1111X111111X11111XX11XX111X1111XX111111111XX11111XX1111X11111X11X111X11X1111X1111
11X1111X111111X11111X111X1111X1111X11111111111XX11111X1111X11111X11X111X11X1111XX111
1XX1111X111111X1111XX111X1111X1111X1111XXXX1111XX1111X1111X11111X11X111X11X11111X111
1X11111X111111XX111X111XX1111X1111X111XX11XX1111XX111X1111X11111X11X111X11X11111X111
1X11111X11111XX1111X111X11111X1111111XX1111111111X111X1111XX1111X11X111X11X11111X111
1X11111X11111X11111X111X11111X111X111XXXXX11X1111X111X11111X1111X11X111X11X11111X111
1X11111X11111X11111X11XX11111X111X111X11GX11X1111X111X11111X1111X11X111X11X11111X111
1X11111XX1111X1111XX11X111111X111X111X1XXX11X1111X111111111X1111X11X111X11X11111X111
1X11111X11111X1111XX11X111111X111X111X11111XX1111X1111X1111X1111X11X111X11X11111X111
1X11111X11111X1111X111X111111X111X111XXXXXXX11111X1111X1111X1111X11X111X11X11111X111
1X11111X11111X1111X111X111111X111XX1111111111111XX1111X1111X1111X11X111X11X11111X111
1XX111XX11111X1111X111X111111X1111X111111111111XX11111X1111X1111X11X111X11X11111X111
11X111XX11111X1111X111X111111X1111XXXX11111111XX11111XX1111X1111X11X111X11X11111X111
11X111XX11111X1111X111X111111X1111111XXXXXXXXXX111111X11111X1111X11X111X11X11111X111
11X1111X11111X1111X111XX11111XX111111111111111111111XX11111X1111X11X111X11X11111X111
11X1111X11111X1111X1111X111111XX1111111111111111111XX11111XX1111X11X111X11X11111X111
11X1111X11111X1111X1111XX111111XX11111111111111111XX11111XX11111X11X111X11X1111XX111
11X1111X11111X1111XX1111XX111111XXXXXXXXXXXXXXXXXX111111XX111111X11X111X11X1111X1111
11XX111XX1111X11111X11111XXX111111111111111111111111111XX1111111X11X111X11X1111X1111
111X1111X1111X11111XX111111XXX111111111111111111111111XX1111111XX11X111X11X1111X1111
111X1111X1111XX11111XX1111111XXXX111111111111111111XXXX111111XXX111X111X11X1111X1111
111X1111XX1111X11111XXX111111111XXXXXX11111111XXXXXX11111111XX11111X111X11X1111X1111
111XX1111X1111XX111111XXX111111111111XXXXXXXXXX111111111111XX111111X111X11X1111X1111
1111X1111XX1111X11111111XXXXX111111111111111111111111111XXXXX11111XX111X11X111XX1111
1111X11111X1111XX1111111111XXXXXXX1111111111111111111XXXX111111XXXX1111X11X111X11111
1111XX1111XX1111XXX11111111111111XXXXXXXXXXXXXXXXXXXXX11111111XX1111111X11X111X11111
11111X11111XX11111XXXXXX11111111111111111111111111111111111XXXX11111111X11X111X11111
11111XX11111X1111111111X11111111111111111111111111111111111X11111111111111X111X11111
S11111X1111111111111111XXXXXXXXXXXXXXXXXXXXXXXXXXXXXXXXXXXXX11111111111111X111111111
