X11111111111111S11111111111111111
XX111X111X111X111X111X111X1111111
1XX1XXX1XXX1XXX1XXX1XXX1XXXX11111
11XXX1XXX1XXX1XXX1XXX1XXX11XX1111
111X1111111X111X111111111111XX111
1111111X11111X11111X11111X111X111
111X11XXX111XXX111XXX111XXX1XX111
11XXX111XX1XX1XX1XX1XX1XX1XXX1111
111XX1111XXX111XXX111XXX111X11111
11XX11111111111111111111111111111
1XX111111111111111111111111111111
1X111111X111111X11111X111111X1111
1XX1111XXX1111XXX111XXX1111XXX111
11XX11XX1XX11XX1XX1XX1XX11XX1XX11
111XXXX111XXXX111XXX111XXXX111X11
111111111111111G1X111111111111111
