S111111X111111X1111X111X111X1X111XX1X11111XX1111111111111X11X111111X1111X11111111111
11XXXX1XXXX1XXX1X1XXX111XXXXX1XXX1XX1XXX1XXX1XXX1X1X1X1X11X1X1XXX1XXX1X11X1XX11XXX11
X111X111111111111111XXXX1X11111111111X1111111111111111111111111111111111111111X11X11
X11XX1X111111XX111X1XXX1111X11X1111XXXXX1XXX1X1XX1XXXXXXXXXXX1X1111XX111XXXXXXXXXXX1
111111X1XXX11X111111X111111X11X11X11XX111X1111X1111X111X1111111XXXXXXX1XXXX11X111111
X1XXXX11X111111XX111111X1X1X11111111X1X1XX11X1X11X111X1X11111111X11X111X1111XX111111
X1111X111X111111X111X1X111XX11X11111111X1X11X111XX11X11X111X1111X1X11X111111111111X1
XXX1XX11XX11XXX11XX1111XX111X1111XX1X1111X1111X1X111XX1111X1111111111X11X11111X11111
XXXX1XX1X111111X1XX1X11X1XX1X111XXXXXXX11X11X1X1X111X11XX1X111XXXX11X111X1X1XX11111X
X1X1111X1X11XX111X1111111XX111X1XX111X11XXXX11X1111X11111XX1XXX1XXX111X1X111XX1XX1XX
X111111111XX11X111111X111X1111X11XXXX1X1XX111X1111X1X1111X1X11111X1111111X11XXX11111
11X11111111X11111X11X11111XX1XX11X11111X1111XXX11XX1111X1111XXXX1X11X1X11X1X111X11X1
X1111111X1XXX11XX11111X111X111X1X1X11111X1X1X111X11X11X1X1X111XX11XX1X1X1XX11X111XXX
1111X111XX11111X111X11111XXXXX1XX11XX1XXXX11X1X1XX111X1XXXX1X1111XX1X1XX11XX11X11111
XX1X11XXXX1X11X11XX11X11XXXX11X1111XX11X1XXX1X11X11111X1111X111111XX11X1X1X1111111X1
11X11X11XXX1X11X11XX1X111X11XX1X1X111111111X1X11X11X11X11X1XXXXXX1X1111XX1X11X111XX1
X11111111XX1111X1XX1X11X1X111XXX1111X11111XX1X1X111X11111X11X1111XX11X1XXXX111X11111
1XX1111XXXX1XXXXXX11X1XXXX1X1XX1XX1X1XX111X1X1111X1XXX11X11X1111111111XX111111111111
1X111X1XXX111X11XX1111XXX11XXX1X1X1X1XX11XXXXXXXX1XX1X1X1X111XX11XXX111X1X1X11111111
1111X111X1X1XX1111X11X11111XX1XX1111X11111111111XX1X111XXX11X11XX1X111111111XX1X1111
1111X111X111111XX11XX111111111X11XXXX1X1X11X11X1XX11X1XX1111XX11111XX11X11X11X111111
XXXX11XX1X1XXXX111X111X1X1X1X1XX1XXX11XXXXXX1X11XX1111XX11X1XX11X1XXX11X1X11111111X1
111X11X1111X11111XX1X1111X111X1XX1XX1XX1XX1XXX1111X1XX111111XX1111XX1X1XX11XXX111111
11XX11XX1111111XXXX111XX111X11X11111111X1111111111X1X111XX1X1XX1111X11XX11X1XXX1X111
111X11XXX11111111X1X11X11XX1X1111XX1111X1X11X11X1XX11X11X1111XX1X1111X1XX1111X11X111
XX1X1111XXXXX11111X111X1X111XXXXX11XXX11X111X111XXXXXX11XX1X11XX111111X1111X1XX111XX
XX1111111X1X1111XXX1X11111XX11111111111111111XX1X11X11X11X1111XXX1XX1XX111X1XX11X11X
X1X111X11111111X11XXXX1X11X111111X1X11X1X111X11X11111111X1X1111111XXX1X1XXX111X1X111
X1111XX1XXX1111X1111XXXX111X11XX1X111X11111XX1X11X1X11XX11X1111111111X1111X11X11X111
1111X1X1111XX11XXX1111X1X111X11111XX1111X111X11X11XX11X111XX1X111X111XX11X1X11111X11
11111X111X1111X11X11111X11111XX11X11X11XX1XXX111X1X11X1111XX1XXX1XXXXX11X111X1X11111
111X1X11X1X1111X11XXXX1XX11XX1X11X1X11111XX1X1XXX111111XX11X1111XX1X111X1X111XXX1X11
XX11111X11111111X111111XX11111X111111X1111X1X11X11XXXXXX1XXX1XXX1X1X1X11X1X111XX1111
11111111111X1X1111X11111X1111XX11X11X111111XX1111X11X111XXXX1X111X1XX1111111XX111111
X1111111XXXXX11X111X1111XX1111111X11X1X1111111X1X1XXX1XX1X1111111X11XXX1X1X1X11X1X11
1X111XX11X111111X111X1XXX1111XX111XXX11XX1X11X1111X111X1XX1X11X11111XX11XX11X11X1111
1X1111XX1X1111X11X111X11XX1X1X111X1111XX1111XX11111X111X11XX1111X1X1XXX1XX11X11X1111
111X11X11X1111X1111111X1XX111X111X1111XX1XX111X11X111X11111XX111111X1111X111XX111111
111XX11X1X11111XXX11111X11111XXXX111X1111111X1XX11X11X111XX111X11X11XXX11X111XX11111
11111X111111111111X11X1111111111111XXX1111XX111111X1111111XX1111XXXXX1X1X1XX11X1111G
