S11111111111111111111111111111XX1
11111XX111111111111111X111111XX11
1111XX111XX111XX11111XX11111XX111
111XX111XX111XX11111XX11111XX1111
11XX111XX111XX11111XX11111XX11111
1XX111XX111XX11111XX11111XX111111
1X111XX111XX11111XX11111XX1111111
1111XX111XX11111XX11111XX11111111
111XX111XX11111XX11111XX111111XX1
11XX111XX11111XX11111XX111111XX11
11X111XX11111XX11111XX111111XX111
11111XX11111XX11111XX111111XX111X
1111XX11111XX11111XX111111XX111XX
111XX11111XX11111XX111111XX111XX1
111X11111XX11111XX111111XX111XX11
11111111XX1111111111111XX1111111G
