S1111XX999999XX1111111111111111111111111111111
9111XX999999XX11199XXXXXXXXXX999999XX111111111
9111X999999XX1119XXX11111111XXXX9999XX11111111
911XX9999XX11119XX99199XXX91111XX9999XXXXX1111
911X99999X11119XX9991XXX1XX99911XX9999X9999111
911X99999X1119XX99991X1111XXXX911XX999X9999111
911X9999X1119XX9999X111111111XX911X999XX999X91
911X9999XX119X9999XX1199999991XX91XX999X999X91
91XX99999X119X9999X99XXXXXXX911X911X999X999X91
91X999999X119X999XX99X11111X911X911X999X99X991
91X999999X119X999X999X1XXX1XX1XX911X999X99X911
91X999999X111X999X999XGX9XX111XX91XX999X99X911
91X999999XX11X999XX99XXX99XXXXX911X9999X99X911
91XX999999X11X9999XX999XX9999XX911X9999X99X911
911X9999999X1X99999XX9999999XXX911X999XX99X911
911XX99999911XX99999XXXXXXXXX11111X999X999X911
9111X999999111XX999999999911111111XXXXX999X911
9111XXX9991111XXXXX99999991119XXX9999X999XX911
911111XXX91111X999XXXXX999111XX999999XX9XX9111
91111111XX1111XX999999XXXXXX1XX999XXXXXX991111
911111111111111XXX999999999919XXXXX999X9911111
91111111111111111XX999999999111111111111111111
