11111111XX111111S1111111111111111
11X111111XX11111X11111XX111111X11
1XXX111111XX111XXX111XX111111XXX1
1X11111XX11XX1XXGXX1XX11XX11111X1
111XXX1XX111XXX111XXX111XX1XXX111
111XXXX11111XX11X11XX11111XXXX111
1111XXXX111XX11X1X11XX111XXXX1111
X1111XXX11XX11X111X11XX11XXX1111X
XX1111XX11XX11X111X11XX11XX1111XX
XXX1XXX1111XX1X111X1XX1111XXX1XXX
111111111111X11X1X11X111111111111
1X11111X1111XX11X11XX1111X11111X1
1XX111XXX111XXX111XXX111XXX111XX1
11XX1XX1XX1XX1XX1XX1XX1XX1XX1XX11
111XXX111XXX111X1X111XXX111XXX111
111111111111111111111111111111111
