333333311111111SX1111111111333333
33X333399XXXXXXXX199XXXX113333X33
3XXX333999XXG111X19XX99911333XXX3
3X33333XX99XXX11X1XX9999XX33333X3
333XXXXXX999XXX9X1XXX999XXXXXX333
333XXX999999X19XX11XX999999XXX333
3333XX99999XX91X9XX1XX99999XX3333
X3333X9999XX91XX9XXX1XX9999X3333X
XX333X999XX91XX9999XX1XX999X333XX
XXX3XX99XX91XXXXXXX9XX1XX99XX3XXX
6639999XX91XXXXXXXXX9XX1XX9999377
6X39999X11111111111111111X99993X7
6XX999XXX111XXX111XXX111XXX999XX7
66XX9XX6XX1XX6XX1XX7XX1XX7XX9XX77
666XXX666XXX666XXX777XXX777XXX777
666666666666666617777777777777777
