111111111SX11111X111111111111111111199999999999X11111111
1XXXXXXXXXX11111111111111111111111119999XX99999X111X1111
1111111111X11111X111XXXXXXXXXXXXXXXXX9999X99999X111X1111
1111111111X11111X11XXX99999111111111XX111X99999X111X1111
1111111111X1111XX11X99999991111111111X111X99999X111X1111
1111111111X1111X111X999XXXX1XXXXX1111X111X99999X111X1111
XXXXXXXX11X1111X111X99XX11119999X1111X111X99999X111X1111
1111111111X1111X111X99X111XXXX99X1111X111X99999X111X1111
1111111111X1111X111X99X11XX11XX9X1111X111X99999X111X1111
1111111111X1111X111X99X11XG111X9XX111X111X99999X111X1111
11XXXXXXXXX1111X111X99X11X1111X99X111X111X99999X111X1111
1111111111X1111X111X99X11X111X999X111X111X99999X111X1111
1111111111X1111X111X99X11XXX1X999X111X111X99999X111X1111
1111111111X1111X111X99X111111999XX111X111X99999X111X1111
XXXXXXXX11X1111X111X99X11111199XX1111X111X9999XX111X1111
1111111111XX111X111X99XXXXXXXXXX1111XX111X9999X1111X1111
11111111111X111X111X9999999991111111X1111X9999X1111X1111
11111111111X111X111X999999999111111XX111XX999XX1111X1111
11XXXXXXXXXX111X111XXXXXXXXXX1X11XXX111XXX999X11111X1111
11111111111X111XX1111111111111XXXX1111XXXX99XX11111X1111
11111111111X1111XX1111111111111111111XXXXX9XX111111X1111
XXXXXXXXX11XXX111XXXXXX111111111111XXXXXXX9X1111111X1111
1111111111111X11111111XXXXXXXXXXXXXXXXXXXX9X1111111X1111
1111111111111XX111111111111111111111111111111111111X1111
11111111111111XXXXXXXXXXXXXXXXXXXXXXXXXXXXXXXXXXXXXX1111
11111111111111111111111111111111111111111111111111111111
