1111111111111111X1111111111111111111X111111X999999999999
SXXXXXXXXXX11111X1111111111111111111X111XX1X9999XXXX9999
9999999999X11111X111XXXXXXXXXXXXXX1XX1111X1XXX9XX99X9999
9999999999X11111X11XXX1111111111111X11111X1X999X999XXX99
9999999999X1111XX11X11111111111111XX11111X1X9XXX9X9XX999
9999999999X1111X111X111XXXXXXXXXXXX11XXXXX1X999X9X9X9999
XXXXXXXX99X1111X111X11XX111X111111111X111X1XXX9X9X9X9XXX
9999999999X1111X111X11X111XX111111111X111X1X999X9X9X999X
9999999999X1111X111X11X11XX11XXXXXXXXX111X1X9XXX9X9X9999
9999999999X1111X111X11X11X1111X1XX111X111X1X999X9X9XXX99
9999999999X1111X111X11X11X1111X111111X111X1XXX9X9X9X9999
9999999999X1111X111X11X111111XX11X111X111X1X999X9X9X9999
9999999999X1111X111X11X11XXXXX111X111X111X1X9XXX9X9X9999
9999999999X1111X111X11X111111111XX111X111X1X999X9X9X9XX9
99XXXXXXXXX1111X111X11X11111111XX1111X111X1XX9XX9X9X99XX
9999999999XX111X111X11XXXXXXXXXX1111XX111X1X99X99X9X9999
99999999999X111X111X1111111111111111X1111X1X99X9XX9X9999
99999999999X111X111X111111111111111XX111XX199XX9X999XXX9
99999999999X111X111XXXXXXXXXXXX11XXX111XX1199X99X99X9999
99999999999X111XX1111111111111XXXX1111XX1119XX99X99X9999
99999999999X1111XX1111111111111111111XX1111XX999X99X9999
XXXXXXXXX99XXX111XXXXXX111111111111XXXX111GX999XX99X9999
9999999999999X11111111XXXXXXXXXXXX1XXXXXXXXX999X999X9XXX
9999999999999XX111111111111111111111111111XX999X999X9999
99999999999999XXXXXXXXXXXXXXXXXXXXXXXXXXXXX9999X999X9999
9999999999999999999999999999999999999999999999XX99999999
