S1111111111111111111111111111111111
11111111111111111111111111111111111
11X11111111111111111111111111111111
11XXXXXXXXXXXXXXXXXXXXXXXXXXXXXXXX1
1111X111111111111111111111111111111
1111X111111111111111111111111111111
1111X111111111111111111111111111111
1111X11111XXXXXXXXXXXXXXXXXXXXXXXXX
1111X11111X11111111X11111111X111111
1111X11111X11111111X11111111X111X11
1111X11111X111X1111X1111X111X111X11
1111X11111X111X1111X1111X111X111X11
1111X111111111X111111111X1111111X11
1111X111111111X111111111X1111111X11
1111XXXXXXXXXXXXXXXXXXXXXXXXXXXXX11
1111111111111111111111111111111111G
