XXXXXXXXXXXXX
X11117651111X
X11118S41111X
X11111231111X
XXXXXXXXXXXXX