XXXXXXXXXX
X1X931111X
X1XSX1111X
X11X41111X
XXXXXXXXXX